1111111111
1000000E01
1CP0000001
1000C00001
1111111111