1111111111
1000000E01
1CP000C001
1000C00C01
1111111111