111111111111111111111
11111C000000000C11111
1111000000P0000001111
11111C00000000C111111
1110000000P0000111111
111111111111111111111