111111111111111
1000000000000C1
100000000000001
1P0000E00000001
10000000E000001
111111111111111