1111111111
1000000001
100E011101
1CP001C101
1000C11101
1000000001
1111111111