1111111111
1000000011
1000011101
1CP001C101
1000C11101
10000001E1
1111111111