111111111111111111111111111
100000000000000010001001001
100000000000000010001001001
100000000P00000010001001001
100000000000000010E01001001
100000000000000011111001001
1000000000C0000010001001001
100000000000000010001001001
100000000000000010001001001
100000000000000010001001001
100000000000000010001001001
100000000000000010001001001
111111111111111111111111111