111111111111111111111
11111C000E00000C11111
1111000000P0000001111
11111C00000000C111111
111000000000000111111
111111111111111111111