1111111111
100000C001
1CPE00C001
1000C00C01
1111111111